main :- writeln('Hello, World! from XSB').